1:15:36:10	7	6	20	20.8064	99.5681	99.5681
1:15:37:25	7	6	20	20.9439	41.3321	99.5681
1:15:38:35	7	6	20	21.3069	29.8403	99.5681
1:15:39:50	7	6	20	21.424	35.5023	99.5681
1:15:41:0	7	6	20	21.3326	52.3128	99.5681
1:15:42:15	7	6	20	21.1475	70.7396	99.5681
1:15:43:25	7	6	20	21.0166	75.2475	99.5681
1:15:44:40	7	6	20	21.0166	67.459	99.5681
1:15:45:55	7	6	20	21.1584	64.4914	99.5681
1:15:47:5	7	6	20	21.1584	72.512	99.5681
1:15:48:20	7	6	20	21.1584	73.6624	99.5681
1:15:49:30	7	6	20	21.1584	73.6624	99.5681
1:15:50:45	7	6	20	21.1584	71.4734	99.5681
1:15:51:55	7	6	20	21.1584	71.4734	99.5681
1:15:53:10	7	6	20	21.1584	72.4812	99.5681
1:15:54:20	7	6	20	21.1584	67.9873	99.5681
1:15:55:35	7	6	20	21.1584	67.9873	99.5681
1:15:56:45	7	6	20	21.2219	68.1492	99.5681
1:15:58:0	7	6	20	21.2219	72.2873	99.5681
1:15:59:10	7	6	20	21.1965	72.2873	99.5681
1:16:0:25	7	6	20	21.1965	71.4529	99.5681
1:16:1:35	7	6	20	21.1965	71.4529	99.5681
1:16:2:50	7	6	20	21.1965	71.4529	99.5681
1:16:4:0	7	6	20	21.1965	71.4529	99.5681
1:16:5:15	7	6	20	21.1965	71.3855	99.5681
1:16:6:30	7	6	20	21.1965	71.3855	99.5681
1:16:7:40	7	6	20	21.1965	71.3855	99.5681
1:16:8:55	7	6	20	21.1965	71.3855	99.5681
1:16:10:5	7	6	20	21.1965	71.3855	99.5681
1:16:11:20	7	6	20	21.1965	71.3855	99.5681
1:16:12:30	7	6	20	21.1965	71.3855	99.5681
1:16:13:45	7	6	20	21.1965	71.3855	99.5681
1:16:14:55	7	6	20	21.1965	71.3855	99.5681
1:16:16:10	7	6	20	21.1965	71.3855	99.5681
1:16:17:20	7	6	20	21.1965	69.9861	99.5681
1:16:18:35	7	6	20	21.1965	69.6757	99.5681
1:16:19:45	7	6	20	21.1965	69.6757	99.5681
1:16:21:0	7	6	20	21.1965	69.6757	99.5681
1:16:22:10	7	6	20	21.1965	69.6757	99.5681
1:16:23:25	7	6	20	21.1965	69.6757	99.5681
1:16:24:40	7	6	20	21.1965	69.6757	99.5681
1:16:25:50	7	6	20	21.1965	69.6757	99.5681
1:16:27:5	7	6	20	21.1965	69.6757	99.5681
1:16:28:15	7	6	20	21.1965	69.6757	99.5681
1:16:29:30	7	6	20	21.1965	73.7074	99.5681
1:16:30:40	7	6	20	21.1965	73.7074	99.5681
1:16:31:55	7	6	20	21.0785	74.9323	99.5681
1:16:33:5	7	6	20	21.0785	68.1461	99.5681
1:16:34:20	7	6	20	21.1079	68.1461	99.5681
1:16:35:35	7	6	20	21.1079	70.7254	99.5681
1:16:36:45	7	6	20	21.0989	70.7254	99.5681
1:16:38:0	7	6	20	21.0989	70.4874	99.5681
1:16:39:10	7	6	20	21.0989	70.4874	99.5681
1:16:40:25	7	6	20	21.0989	70.4874	99.5681
1:16:41:35	7	6	20	21.0989	70.4874	99.5681
1:16:42:50	7	6	20	21.0989	70.4874	99.5681
1:16:44:0	7	6	20	21.0989	73.67	99.5681
1:16:45:15	7	6	20	21.0989	74.2172	99.5681
1:16:46:25	7	6	20	21.0989	74.2172	99.5681
1:16:47:40	7	6	20	20.9784	74.2172	99.5681
1:16:48:50	7	6	20	20.9784	67.4724	99.5681
1:16:50:5	7	6	20	20.9784	67.7343	99.5681
1:16:51:20	7	6	20	20.9784	67.7343	99.5681
1:16:52:30	7	6	20	21.0066	67.7343	99.5681
1:16:53:45	7	6	20	21.0066	69.3534	99.5681
1:16:54:55	7	6	20	20.9897	74.1311	99.5681
1:16:56:10	7	6	20	20.9897	73.9522	99.5681
1:16:57:20	7	6	20	20.9897	73.8773	99.5681
1:16:58:35	7	6	20	20.9897	73.8773	99.5681
1:16:59:45	7	6	20	20.8944	74.5547	99.5681
1:17:1:0	7	6	20	20.9045	69.1938	99.5681
1:17:2:10	7	6	20	20.9045	68.2892	99.5681
1:17:3:25	7	6	20	20.9045	69.3168	99.5681
1:17:4:35	7	6	20	20.9045	69.3168	99.5681
1:17:5:50	7	6	20	20.9045	69.3168	99.5681
1:17:7:5	7	6	20	20.9045	69.3168	99.5681
1:17:8:15	7	6	20	20.9045	73.3386	99.5681
1:17:9:30	7	6	20	20.884	73.3386	99.5681
1:17:10:40	7	6	20	20.884	72.9636	99.5681
1:17:11:55	7	6	20	20.884	73.132	99.5681
1:17:13:5	7	6	20	20.884	73.132	99.5681
1:17:14:20	7	6	20	20.884	73.132	99.5681
1:17:15:30	7	6	20	20.7919	73.132	99.5681
1:17:16:45	7	6	20	20.7919	73.132	99.5681
1:17:17:55	7	6	20	20.7919	67.5853	99.5681
1:17:19:10	7	6	20	20.7919	67.5853	99.5681
1:17:20:25	7	6	20	20.7919	71.4354	99.5681
1:17:21:35	7	6	20	20.7919	71.4354	99.5681
1:17:22:50	7	6	20	20.7919	71.7508	99.5681
1:17:24:0	7	6	20	20.694	74.3865	99.5681
1:17:25:15	7	6	20	20.694	68.6883	99.5681
1:17:26:25	7	6	20	20.694	68.5794	99.5681
1:17:27:40	7	6	20	20.694	72.949	99.5681
1:17:28:50	7	6	20	20.694	72.949	99.5681
1:17:30:5	7	6	20	20.694	72.949	99.5681
1:17:31:15	7	6	20	20.694	72.949	99.5681
1:17:32:30	7	6	20	20.5914	72.949	99.5681
1:17:33:40	7	6	20	20.6062	66.8957	99.5681
1:17:34:55	7	6	20	20.6062	66.8957	99.5681
1:17:36:10	7	6	20	20.6062	72.6986	99.5681
1:17:37:20	7	6	20	20.5984	73.3449	99.5681
1:17:38:35	7	6	20	20.5984	72.3656	99.5681
1:17:39:45	7	6	20	20.5984	72.3656	99.5681
1:17:41:0	7	6	20	20.5984	72.3656	99.5681
1:17:42:10	7	6	20	20.5984	72.6177	99.5681
1:17:43:25	7	6	20	20.5984	72.6177	99.5681
1:17:44:35	7	6	20	20.4872	72.6177	99.5681
1:17:45:50	7	6	20	20.5176	64.4683	99.5681
1:17:47:0	7	6	20	20.5176	71.5434	99.5681
1:17:48:15	7	6	20	20.5176	73.2016	99.5681
1:17:49:25	7	6	20	20.4942	73.4563	99.5681
1:17:50:40	7	6	20	20.4942	72.7931	99.5681
1:17:51:55	7	6	20	20.4942	71.9324	99.5681
1:17:53:5	7	6	20	20.4942	71.9324	99.5681
1:17:54:20	7	6	20	20.4942	71.9324	99.5681
1:17:55:30	7	6	20	20.4942	71.9324	99.5681
1:17:56:45	7	6	20	20.4942	71.9324	99.5681
1:17:57:55	7	6	20	20.394	76.3135	99.5681
1:17:59:10	7	6	20	20.394	70.5732	99.5681
1:18:0:20	7	6	20	20.4018	70.1975	99.5681
1:18:1:35	7	6	20	20.4018	71.2674	99.5681
1:18:2:50	7	6	20	20.3948	71.2674	99.5681
1:18:4:0	7	6	20	20.3948	71.2674	99.5681
1:18:5:15	7	6	20	20.3948	71.2674	99.5681
1:18:6:25	7	6	20	20.3948	71.2674	99.5681
1:18:7:40	7	6	20	20.3948	71.2674	99.5681
1:18:8:50	7	6	20	20.3948	71.2674	99.5681
1:18:10:5	7	6	20	20.3948	71.2674	99.5681
1:18:11:15	7	6	20	20.3948	75.1083	99.5681
1:18:12:30	7	6	20	20.3948	75.7178	99.5681
1:18:13:45	7	6	20	20.3948	75.7178	99.5681
1:18:14:55	7	6	20	20.3948	75.7178	99.5681
1:18:16:10	7	6	20	20.2896	75.7178	99.5681
1:18:17:20	7	6	20	20.2896	69.0594	99.5681
1:18:18:35	7	6	20	20.3112	69.0594	99.5681
1:18:19:45	7	6	20	20.3112	70.762	99.5681
1:18:21:0	7	6	20	20.3112	70.762	99.5681
1:18:22:10	7	6	20	20.3112	70.762	99.5681
1:18:23:25	7	6	20	20.3112	70.762	99.5681
1:18:24:35	7	6	20	20.2926	70.762	99.5681
1:18:25:50	7	6	20	20.2926	70.6715	99.5681
1:18:27:5	7	6	20	20.2926	70.6715	99.5681
1:18:28:15	7	6	20	20.2926	70.4485	99.5681
1:18:29:25	7	6	20	20.2926	75.8568	99.5681
1:18:30:40	7	6	20	20.2926	75.8568	99.5681
1:18:31:55	7	6	20	20.2926	75.8568	99.5681
1:18:33:5	7	6	20	20.1958	75.8568	99.5681
1:18:34:20	7	6	20	20.1958	71.2432	99.5681
1:18:35:30	7	6	20	20.2037	69.6546	99.5681
1:18:36:45	7	6	20	20.2037	69.6546	99.5681
1:18:37:55	7	6	20	20.2037	69.6546	99.5681
1:18:39:10	7	6	20	20.2037	69.6546	99.5681
1:18:40:20	7	6	20	20.2037	69.6546	99.5681
1:18:41:35	7	6	20	20.2037	69.6546	99.5681
1:18:42:45	7	6	20	20.2037	69.6546	99.5681
1:18:44:0	7	6	20	20.2037	69.6546	99.5681
1:18:45:15	7	6	20	20.2037	69.6546	99.5681
1:18:46:25	7	6	20	20.2037	69.6546	99.5681
1:18:47:40	7	6	20	20.2037	69.6546	99.5681
1:18:48:50	7	6	20	20.1928	75.3911	99.5681
1:18:50:5	7	6	20	20.1928	75.6385	99.5681
1:18:51:15	7	6	20	20.1928	75.6385	99.5681
1:18:52:30	7	6	20	20.1928	75.6385	99.5681
1:18:53:40	7	6	20	20.1928	75.6385	99.5681
1:18:54:55	7	6	20	20.1928	75.6385	99.5681
1:18:56:5	7	6	20	20.1928	75.6385	99.5681
1:18:57:20	7	6	20	20.1928	75.6385	99.5681
1:18:58:30	7	6	20	20.1928	75.6385	99.5681
1:18:59:45	7	6	20	20.0928	76.3326	99.5681
1:19:0:55	7	6	20	20.1044	70.6743	99.5681
1:19:2:10	7	6	20	20.1044	70.6743	99.5681
1:19:3:25	7	6	20	20.1044	69.8801	99.5681
1:19:4:35	7	6	20	20.1044	69.8801	99.5681
1:19:5:50	7	6	20	20.1044	69.8801	99.5681
1:19:7:0	7	6	20	20.1044	69.8801	99.5681
1:19:8:15	7	6	20	20.1044	69.8801	99.5681
1:19:9:25	7	6	20	20.1044	69.8801	99.5681
1:19:10:40	7	6	20	20.1044	69.8801	99.5681
1:19:11:50	7	6	20	20.1044	69.8801	99.5681
1:19:13:5	7	6	20	20.1044	69.8801	99.5681
1:19:14:15	7	6	20	20.1044	69.8801	99.5681
1:19:15:30	7	6	20	20.1044	69.8801	99.5681
1:19:16:45	7	6	20	20.1044	69.8801	99.5681
1:19:17:55	7	6	20	20.1044	69.8801	99.5681
1:19:19:10	7	6	20	20.1044	69.8801	99.5681
1:19:20:20	7	6	20	20.1044	69.8801	99.5681
1:19:21:35	7	6	20	20.1044	69.8801	99.5681
1:19:22:45	7	6	20	20.1044	69.8801	99.5681
1:19:24:0	7	6	20	20.1044	69.8801	99.5681
1:19:25:10	7	6	20	20.1044	69.8801	99.5681
1:19:26:25	7	6	20	20.1044	69.8801	99.5681
1:19:27:35	7	6	20	20.1044	69.8801	99.5681
1:19:28:50	7	6	20	20.1044	70.1674	99.5681
1:19:30:5	7	6	20	20.1044	71.2346	99.5681
1:19:31:15	7	6	20	20.1044	70.6933	99.5681
1:19:32:25	7	6	20	20.1044	70.6933	99.5681
1:19:33:40	7	6	20	20.1044	70.6933	99.5681
1:19:34:55	7	6	20	20.1044	70.6933	99.5681
1:19:36:5	7	6	20	20.1044	70.6933	99.5681
1:19:37:20	7	6	20	20.1044	70.6933	99.5681
1:19:38:30	7	6	20	20.1044	70.6933	99.5681
1:19:39:45	7	6	20	20.1044	70.6933	99.5681
1:19:40:55	7	6	20	20.1044	70.6933	99.5681
1:19:42:10	7	6	20	20.1044	70.6933	99.5681
1:19:43:20	7	6	20	20.1044	74.5337	99.5681
1:19:44:35	7	6	20	20.0978	74.5337	99.5681
1:19:45:50	7	6	20	20.0978	74.5337	99.5681
1:19:47:0	7	6	20	20.0978	74.5337	99.5681
1:19:48:10	7	6	20	20.0978	74.5337	99.5681
1:19:49:25	7	6	20	20.0978	74.5337	99.5681
1:19:50:40	7	6	20	20.0978	74.5337	99.5681
1:19:51:50	7	6	20	20.0978	74.5337	99.5681
1:19:53:5	7	6	20	20.0978	74.5337	99.5681
1:19:54:15	7	6	20	20.0978	74.5337	99.5681
1:19:55:30	7	6	20	20.0978	74.5337	99.5681
1:19:56:40	7	6	20	20.0978	74.5337	99.5681
1:19:57:55	7	6	20	20.0978	74.5337	99.5681
1:19:59:5	7	6	20	20.0978	74.5337	99.5681
1:20:0:20	7	6	20	20.0978	74.5337	99.5681
1:20:1:30	7	6	20	20.0978	74.5337	99.5681
1:20:2:45	7	6	20	20.0978	74.5337	99.5681
1:20:3:55	7	6	20	20.0978	74.5337	99.5681
1:20:5:10	7	6	20	19.9986	74.5337	99.5681
1:20:6:20	7	6	20	20.0065	69.2363	99.5681
1:20:7:35	7	6	20	20.0065	69.468	99.5681
1:20:8:50	7	6	20	20.0065	70.1052	99.5681
1:20:10:0	7	6	20	20.0065	69.3864	99.5681
1:20:11:15	7	6	20	20.0065	69.3864	99.5681
1:20:12:25	7	6	20	20.0065	69.3864	99.5681
1:20:13:40	7	6	20	20.0065	69.3864	99.5681
1:20:14:50	7	6	20	20.0065	69.3864	99.5681
1:20:16:5	7	6	20	20.0065	69.3864	99.5681
1:20:17:15	7	6	20	20.0065	69.3864	99.5681
1:20:18:30	7	6	20	20.0065	69.3864	99.5681
1:20:19:45	7	6	20	20.0065	69.3864	99.5681
1:20:20:55	7	6	20	20.1028	69.3864	99.5681
1:20:22:10	7	6	20	20.1028	73.7645	99.5681
1:20:23:20	7	6	20	20.095	75.3793	99.5681
1:20:24:35	7	6	20	20.095	75.3793	99.5681
1:20:25:45	7	6	20	20.095	75.3793	99.5681
1:20:27:0	7	6	20	20.095	74.8704	99.5681
1:20:28:10	7	6	20	20.106	74.8704	99.5681
1:20:29:25	7	6	20	20.106	74.8704	99.5681
1:20:30:35	7	6	20	20.106	69.6892	99.5681
1:20:31:50	7	6	20	20.106	70.3645	99.5681
1:20:33:5	7	6	20	20.106	70.0513	99.5681
1:20:34:15	7	6	20	20.106	70.0513	99.5681
1:20:35:30	7	6	20	20.106	70.0513	99.5681
1:20:36:40	7	6	20	20.106	70.0513	99.5681
1:20:37:55	7	6	20	20.2016	68.9966	99.5681
1:20:39:5	7	6	20	20.2016	74.6533	99.5681
1:20:40:20	7	6	20	20.2016	74.6533	99.5681
1:20:41:30	7	6	20	20.2016	74.9434	99.5681
1:20:42:45	7	6	20	20.2016	75.2082	99.5681
1:20:44:0	7	6	20	20.2016	69.9959	99.5681
1:20:45:10	7	6	20	20.2016	69.9959	99.5681
1:20:46:25	7	6	20	20.2016	70.5254	99.5681
1:20:47:35	7	6	20	20.3145	69.6738	99.5681
1:20:48:50	7	6	20	20.3145	76.3586	99.5681
1:20:50:0	7	6	20	20.3145	76.3586	99.5681
1:20:51:15	7	6	20	20.3145	76.3586	99.5681
1:20:52:25	7	6	20	20.3145	76.595	99.5681
1:20:53:40	7	6	20	20.3145	72.0675	99.5681
1:20:54:50	7	6	20	20.3145	71.6761	99.5681
1:20:56:5	7	6	20	20.3145	71.6761	99.5681
1:20:57:20	7	6	20	20.3145	71.6761	99.5681
1:20:58:30	7	6	20	20.4186	70.2707	99.5681
1:20:59:45	7	6	20	20.4186	76.2797	99.5681
1:21:0:55	7	6	20	20.4186	76.5925	99.5681
1:21:2:10	7	6	20	20.4186	73.182	99.5681
1:21:3:20	7	6	20	20.4186	72.9684	99.5681
1:21:4:35	7	6	20	20.4186	72.9684	99.5681
1:21:5:45	7	6	20	20.5094	71.7471	99.5681
1:21:7:0	7	6	20	20.5094	76.7636	99.5681
1:21:8:10	7	6	20	20.5094	71.891	99.5681
1:21:9:25	7	6	20	20.5094	71.891	99.5681
1:21:10:35	7	6	20	20.6092	72.5893	99.5681
1:21:11:50	7	6	20	20.6092	76.4418	99.5681
1:21:13:0	7	6	20	20.6092	76.4418	99.5681
1:21:14:15	7	6	20	20.6092	72.2915	99.5681
1:21:15:25	7	6	20	20.6092	72.2915	99.5681
1:21:16:40	7	6	20	20.6092	72.8912	99.5681
1:21:17:50	7	6	20	20.7034	71.7942	99.5681
1:21:19:5	7	6	20	20.7034	77.2535	99.5681
1:21:20:20	7	6	20	20.7034	77.2535	99.5681
1:21:21:30	7	6	20	20.7034	71.0723	99.5681
1:21:22:45	7	6	20	20.7034	71.7984	99.5681
1:21:23:55	7	6	20	20.7034	72.0467	99.5681
1:21:25:10	7	6	20	20.8129	71.5938	99.5681
1:21:26:20	7	6	20	20.8129	72.8561	99.5681
1:21:27:35	7	6	20	20.8129	72.8561	99.5681
1:21:28:45	7	6	20	20.8129	74.1501	99.5681
1:21:30:0	7	6	20	20.8129	74.1501	99.5681
1:21:31:10	7	6	20	20.9073	73.6945	99.5681
1:21:32:25	7	6	20	20.9073	79.074	99.5681
1:21:33:40	7	6	20	20.9073	72.9657	99.5681
1:21:34:50	7	6	20	20.9073	73.5622	99.5681
1:21:36:5	7	6	20	20.9073	73.5622	99.5681
1:21:37:15	7	6	20	21.0008	73.7915	99.5681
1:21:38:30	7	6	20	21.0008	78.3165	99.5681
1:21:39:40	7	6	20	21.0008	72.7805	99.5681
1:21:40:55	7	6	20	21.0008	73.5171	99.5681
1:21:42:5	7	6	20	21.0008	73.5171	99.5681
1:21:43:20	7	6	20	21.0008	73.7646	99.5681
1:21:44:30	7	6	20	21.1177	73.0892	99.5681
1:21:45:45	7	6	20	21.1177	73.6724	99.5681
1:21:46:55	7	6	20	21.1177	73.6724	99.5681
1:21:48:10	7	6	20	21.1177	75.2979	99.5681
1:21:49:25	7	6	20	21.2045	75.2979	99.5681
1:21:50:35	7	6	20	21.2045	79.7481	99.5681
1:21:51:50	7	6	20	21.2045	74.0609	99.5681
1:21:53:0	7	6	20	21.2045	74.5614	99.5681
1:21:54:15	7	6	20	21.2045	74.5614	99.5681
1:21:55:25	7	6	20	21.301	74.5614	99.5681
1:21:56:40	7	6	20	21.301	79.4253	99.5681
1:21:57:50	7	6	20	21.301	74.3835	99.5681
1:21:59:5	7	6	20	21.301	74.9828	99.5681
1:22:0:20	7	6	20	21.301	74.9828	99.5681
1:22:1:30	7	6	20	21.4069	75.2114	99.5681
1:22:2:45	7	6	20	21.4069	80.9939	99.5681
1:22:3:55	7	6	20	21.4069	74.2517	99.5681
1:22:5:10	7	6	20	21.4069	74.8969	99.5681
1:22:6:20	7	6	20	21.4069	74.8969	99.5681
1:22:7:35	7	6	20	21.5074	74.8969	99.5681
1:22:8:45	7	6	20	21.5074	74.8969	99.5681
1:22:10:0	7	6	20	21.5074	74.8969	99.5681
1:22:11:10	7	6	20	21.5074	74.8969	99.5681
1:22:12:25	7	6	20	21.5074	76.5624	99.5681
1:22:13:35	7	6	20	21.6067	76.5624	99.5681
1:22:14:50	7	6	20	21.6067	75.0711	99.5681
1:22:16:0	7	6	20	21.6067	75.0711	99.5681
1:22:17:15	7	6	20	21.6067	75.0711	99.5681
1:22:18:25	7	6	20	21.6067	75.7438	99.5681
1:22:19:40	7	6	20	21.7008	75.3801	99.5681
1:22:21:5	7	6	20	21.7008	75.3801	99.5681
1:22:22:15	7	6	20	21.7008	75.3801	99.5681
1:22:23:30	7	6	20	21.7008	75.3801	99.5681
