1:20:42:40	5	6	22.0	20.9124	15.3721
1:20:43:50	5	6	22.0	21.0856	15.3721
1:20:44:55	5	6	22.0	21.1696	15.3721
1:20:46:5	5	6	22.0	21.252	15.3721
1:20:47:10	5	6	22.0	21.4121	15.3721
1:20:48:15	5	6	22.0	21.4121	15.3721
1:20:49:25	5	6	22.0	21.566	15.3721
1:20:50:30	5	6	22.0	21.6407	15.3721
1:20:51:40	5	6	22.0	21.714	15.3721
1:20:52:45	5	6	22.0	21.714	15.3721
1:20:53:55	5	6	22.0	21.8563	15.3721
1:20:55:0	5	6	22.0	21.9253	15.3721
1:20:56:5	5	6	22.0	21.9253	15.3721
1:20:57:15	5	6	22.0	22.1245	15.3721
